111111111111111111111
1E0000000000000C00001
101001010010000010101
101001001010101000101
100000000C00C00000001
100000000C00C00000001
1P0000000C00C00000001
111111111111111111111