1111111111111
10010000000C1
1000011111001
1PCC11E000001
1111111111111